HHHHHHHHHHHHHHHHHH
H1111111111111111H
H10L0000000000L01H
H1FF0000000000FF1H
H10KKKKKKKKKKKK01H
H10K000GGG0000K01H
H10K0111001110KT1H
H10K0100000010K01H
H10K0101110010K01H
H10K0101110010K01H
H10K0100XY0010K01H
H10K0111001110K01H
H10K0000GGG000K01H
H1NK0L000000L0K01H
H10KKKKKKKKKKK001H
H1FF0000000000FF1H
H1111111111111111H
HHHHHHHHHHHHHHHHHH