HHHHHHHHHHHHHHHHHH
H1111111111111111H
H1000000000000001H
H10H0H0H0H0H0H001H
H1000H0H0H0H0H001H
H10HHH0H0H0H0H001H
H100000H0H0H0H001H
H10HHHHH0H0H0H001H
H10000000H0H0H001H
H10HHHHHHH0H0H001H
H1000000Y00H0H001H
H10HHHHHHHHH0H001H
H1000000X0000H001H
H10HHHHHHHHHHH001H
H1000000000000001H
H1000000000000001H
H1111111111111111H
HHHHHHHHHHHHHHHHHH