HHHHHHHHHHHHHHHHHH
H1111111111111111H
H1000000000000001H
H1000000000000001H
H1000000000000001H
H1000000000000001H
H1000111001110001H
H1000100000010001H
H1000100000010001H
H1000100000010001H
H1000100XY0010001H
H1000111001110001H
H1000000000000001H
H1000000000000001H
H1000000000000001H
H1000000000000001H
H1111111111111111H
HHHHHHHHHHHHHHHHHH