HHHHHHHHHHHHHHHHHH
H1111111111111111H
H1000000000000001H
H10X0000000000001H
H1000000000000001H
H1000000000000001H
H1000111111110001H
H1000100000010001H
H1000100000010001H
H1111100000011111H
H1000100000010001H
H1000100000010001H
H1000111111110001H
H1000000000000001H
H1000000000000Y01H
H1000000000000001H
H1111111111111111H
HHHHHHHHHHHHHHHHHH